...................
.....1.............
...................
.56667..2..........
.8999A.............
.BCCCD.3.1.........
.....4444..........
......4444.........
.......44..........
...EFG.............
...HIJ.............
...HIJ.............
...HIFG............
...HILM............
...HIJ.............
...KLM.............
...................
.........EFFFG.....
.........HIIIJ.....
.........KLLLM.....
...................